Swer	PRON	Swer
an	ADP	an
rehte	ADJ	reht
güete	NOUN	güete
wendet	VERB	wenden
sîn	DET	sîn
gemüete	NOUN	gemüete
,	PUNCT	,
dem	PRON	der
volget	VERB	volgen
Saelde	NOUN	sælde
und	CONJ	und
êre	NOUN	êre
.	SPUNCT	.
des	PRON	der
gît	VERB	geben
gewisse	ADJ	gewis
lêre	NOUN	lêre
künecArtûsderguoteArtûs	ADJ	<unknown>
,	PUNCT	,
